G,M,M,G,T,G,T,B,G,B,G
G,G,G,G,G,G,T,T,G,M,M
G,G,R,G,G,G,G,G,G,G,G
G,G,R,G,G,G,G,G,G,G,G
G,G,R,R,M,G,G,G,G,G,G
G,G,G,G,G,G,G,G,G,G,G
G,G,G,G,G,G,G,G,G,G,G
G,G,G,G,G,M,G,G,R,G,G
G,G,T,G,G,G,G,G,R,G,G
G,G,G,G,G,G,G,T,T,G,G
G,G,G,G,G,G,G,G,G,G,G